+-+-+-+-+-+-+-+-+-+-+-+-+-+-+-+-+-+-+-+-+
|   |       |   |       |     |         |
+-+-+-+-+-+ +-+ + +-+-+ + +-+ + +-+ + + +
|     |     |   | |     | |   | | | | | |
+ + + +-+-+ + +-+ + +-+-+ + +-+ + + + +-+
| | | |     |   | | |   | | |   |   |   |
+ +-+ + +-+-+-+ + + +-+ + + + +-+-+-+-+-+
| |   |   |   | | |   | | | | |         |
+ + +-+ + +-+ + + +-+ + + + + + + +-+-+-+
| |   | | |   | | |   | | |   | | |   | |
+ +-+ +-+ + +-+ +-+ +-+ + +-+-+ + + +-+ +
|   |     |   |         | |     | |     |
+-+ +-+-+-+-+ +-+-+ +-+ + + +-+-+ +-+-+-+
|           | |   |   |   |   |   |   | |
+ +-+-+ +-+ + + + +-+ +-+-+-+ + +-+ + + +
| | |     | |   | |   |       | |   | | |
+ + + +-+ + + +-+ + +-+-+-+-+-+ + + + + +
| | | |   | | | |       |     | | | |   |
+ + + + +-+ + + +-+ +-+ + +-+ + + +-+-+-+
|   | |   |   |   | |   |   | |   |     |
+-+-+ +-+ +-+-+-+ +-+ +-+-+-+ +-+-+ +-+ +
|   |   | |     |     |     | |   |   | |
+ + +-+-+ + +-+ +-+ +-+-+-+ + +-+ +-+-+ +
| |   |   | |   |   |           | |     |
+ +-+ + +-+ + +-+ +-+ +-+-+-+ + + + +-+-+
| |   | | | |     |     |     |   | |   |
+ + +-+ + + +-+-+-+ +-+-+ + +-+-+-+ +-+ +
| |     |   |     | |   | | |     |     |
+ +-+-+-+-+-+ + +-+ + + + +-+ +-+ + +-+-+
| |     |   | | |   | | | |   |   |     |
+ + +-+ + + + + + +-+-+ + + +-+ +-+ +-+-+
|   |   | | | | |     | |   |   |   |   |
+-+-+ + + + + + + +-+ + +-+-+ +-+ +-+-+-+
|   | | | | | |   |   | |   | |   |   | |
+ + + + + + + +-+ + +-+ + + + + +-+ + + +
| | | | | | |   | |   | | |   | |   |   |
+ +-+ + +-+ +-+ +-+-+ + +-+-+-+ + +-+ +-+
| |   |   | | | |   | |     |   |   |   |
+ + + +-+ + + + + + + +-+ + + +-+-+ +-+-+
|   |   |   |   | |       | | |         |
+-+-+-+-+-+-+-+-+-+-+-+-+-+-+-+-+-+-+-+-+