+-+-+-+-+-+-+-+-+-+-+-+-+-+-+-+-+-+-+-+-+
|           |   |       |     |         |
+-+-+-+-+-+ +-+ + +-+-+ + +-+ + +-+ + +	+
|     |     |   | |     | |   | | | | | |
+ + + +-+-+ + +-+ + +-+-+ + +-+ + + + + +
| | | |     |   | | |   | | |   |   |   |
+ +-+ + +-+-+-+ + + +-+ + + + +-+-+-+-+-+
| |   |   |   | | |   | | | | |         |
+ + +-+ + +-+ + + +-+ + + + + + + +-+-+-+
| |   | | |   | | |   | | |     | |   | |
+ +-+ +-+ + +-+ +-+ +-+ + +-+-+ + + +-+ +
|   |     |   |         | |     | |     |
+-+ +-+-+-+-+ +-+-+ +-+ + + +-+-+ +-+-+-+
|           | |   |   |   |   |   |   | |
+ +-+-+ +-+ + + + +-+ +-+ +-+ + +-+ + + +
| | |     | |   | |   |       | |   | | |
+ + + +-+ + + +-+ + +-+-+-+-+-+ + + + +-+
| | | |   | | | |       |     | | | |   |
+ + + + +-+ + + +-+ +-+ + +-+ + + + +-+-+
|   | |   |   |   | |   |   | |   |     |
+-+-+ +-+ +-+-+-+ +-+ +-+-+-+ +-+-+ +-+ +
|   |   | |     |     |     | |   |   | |
+ + +-+-+ + +-+ +-+ +-+-+-+ + +-+ +-+-+ +
| |   |   | |   |   |           | |     |
+ +-+ + +-+ + +-+ +-+ +-+-+-+ + + + +-+-+
| |   | | | |     |     |     |   | |   |
+ + +-+ + + +-+-+-+ +-+-+ + +-+-+-+ +-+ +
| |     |   |     | |   | | |     |     |
+ +-+-+-+-+-+ + +-+ + + + +-+ +-+ + +-+-+
| |         | | |   | | | |   |   |     |
+ + +-+ + + + + + +-+-+ + + +-+ +-+-+-+-+
|   |   | | | | |     | |   |   |       |
+-+-+ + + + + + + +-+ + +-+-+ + + +-+-+-+
|   | | | | | |   |   | |   | |   |   | |
+ + + + + + + +-+ + +-+ + + + + +-+ + + +
| |   | |   |   | |   | | |   | |   |   |
+ +-+ + +-+ + + +-+ + + +-+-+-+ + +-+ +-+
|   | |   |   | |   | |     |       | | |
+ +-+ + +-+ +-+ +-+-+ + +-+ +-+ + +-+ + +
| |   | |   |   |     |   |   | |   |   |
+-+-+-+-+-+-+-+-+-+-+-+-+-+-+-+-+-+-+-+-+